TILEMAP
105 8 							-- Size of tile map in tiles
64 64 							-- Tile size & block size
images/tiles012x.png 	-- Tilesheet
2 32 								-- Number of tiles in tilesheet
040404040404040404040404040404040404040404040404040404040404040404040404040404040404040414151515151515151515151515151515151515151515151515151515151515151515151515151515151515151515151515151515151515151515040404
040404252627262804042526272627262726272628040404040404040404040404040404040404040404040407070707070707070707070707070707070707070707070707070707070707070707070707070707070707070707070707070707070707070707040404
040404293031303204042930313031303130313032040404040404040404040404040404040404040404040413131313131313131313131313131313070707070713131313130707070707070707071313070707070707070707070707070707070707070707040404
040102020301030101020202030102020202020203010202030404040401020202030404040404040404040409090909090909090909090909090909131313131309090909090713130707070707130909071313070707070707070707070713131313070707040404
040909090909090909090909090909090909090909090909093334343509090909093334343509090909090909091010101010101010101010101009090909090909101010101309090713130707090910070909131313130707070707131309090909130707040404
171010101009090910101010100909101010101010090909101717171710101010101717171710101010101010101010101010090909090909091010101010101010100910090909100709091313101010071009090909090707131307090910101010091307040404
181919192010101009101009191010191919101010101010111717171719191919191717171719201010101010101010090920101010101010101010100909100909101010101010100710090909101009071010101010101307090907101010090909100913040404
171717171721212123121217172121171717171212112121171717171717171717171717171717222121212123121212112117212121231209090909091010101010101010101010100709101010100910071010101009090907101007101009090909090909090909