TILEMAP
40 8 							-- Size of tile map in tiles
64 64 							-- Tile size & block size
images/tiles032x.png 	-- Tilesheet
2 16 								-- Number of tiles in tilesheet
23232323232323232323232323232323232323232323232323232323232323232323232323232323
23232323232323232323232323232323232323232323232323232323232323232323232323232323
23232323232323232323232323232323232323232323232323232323232323232323232323232323
23232323232323232323232323232323232323232323232323232323232323231417181619191919
23232323232323232323232323232323232323231920050505050505050505050609101305050505
02020202020202020202020202020202020202022122070707070707070707070811121507070707
04040404040404040404040404040401010101010101010101010101010101010101010101010101
03030303030303030303030303030303030303030303030303030303030303030303030303030303
